111111
1DCCD1
1CDDC1
1CDDC1
1DCCD1
11111B